00000000000000000000
00000000000000000000
00000000000000000000
00000000000000000000
00000000000000000000
00000024222220000000
00000020200020000000
00000020202020000000
00000020202020000000
00000023202120000000
00000020202020000000
00000020002520000000
00000022222420000000
00000000000000000000
00000000000000000000
00000000000000000000
00000000000000000000
00000000000000000000
00000000000000000000
00000000000000000000
