02020000044400022000
00020000004400002000
00002000004400002000
00000000004200000000
00000000004000020000
00000000404000000000
00000000404000002000
00000000240000000000
00000000040000020000
00000003040010000000
00000000044000000000
00000000404000000000
00000000400000020000
00000000000000000000
00002004000000000000
00000000000400000200
00000000000000000000
00020004000400000000
00000004000000000000
00000000000000000000
