00000000000000000000
00000000000000000000
00000004000400000000
00000004000400000000
00000004000400000000
00000004010400000000
00000004000400000000
00000004444400000000
00000000000000000000
00000002222200000000
00000002000200000000
00030000000000000000
00000000000000000000
00000000000000000000
00000000000000000000
00000000000000000000
00000000000000000000
00090000000000000000
00000000000000000000
00000000000000000000
