00000000000000000000
00000000000000000000
00000000000000000000
00000000000020000000
00000000000000000000
00000000000000000000
00000000000000000000
00022222222202222000
00020000002000002000
00020300802080102000
00020000002000002000
00022222022222222000
00000000000000000000
00000000000000000000
00000000000000000000
00000000200000000000
00000000000000000000
00000000000000000000
00000000000000000000
00000000000000000000
