00000000000000000000
00000000000000000000
00000000000000000000
00000000000000000000
00000000000000000000
00022222222222222000
00020000000800002000
00000100008000002000
00020000080000002000
70022222222220222000
07027000000000002000
00720700000000002000
0c020070000000002000
70020007000000002000
07020000700000002000
00720000070000002000
00000000000000000000
03000000000000000000
00000000000000000000
00000000000000000000
