00000000000000000000
00000000000000000000
00000000000000000000
00000000000000000000
00002222222222220000
00002444444444420000
00002400000000420000
00002400000000420000
00002400000000420000
0b002400001000420000
00002400000000420000
00002400000000420000
00002400000000420000
00002400000000420000
00002400000000420030
00002400000000420000
00002400000000420000
00002400000000420000
00002400000000420000
00002400000000420000
